########
##    ##
####  ##
##   ###
#   ####
###  ###
##E#####