#$$%####
# F ####
#  E ###
\##  ###
#### ##@
da #####