   ###E######
   #   # # 
  #### ## #
## #   ####
   ### #######
   #S  ####