    #
#   #
    #   #
#####S#####
##     ####
#####  ####
###### ####
#####  ####
###   #####
#####E#####
##
#       #