#####S####
#### #####
##    ####
##   #####
#  #######
##  ######
### ######
##  ######
## #######
##    ####
#### #####
##    ####
##   #####
#  #######
##  ######
### ######
##  ######
## #######
##    ####
#### #####
##    ####
##   #####
#  #######
##  ######
##    ####
#### #####
##    ####
##   #####
#  #######
##  ######
### ######
##  ######
## #######
##    ####
#### #####
##    ####
##   #####
#  #######
##  ######
### ######
##  ######
## #######
##    ####
#### #####
##    ####
##   #####
#  #######
##  ######
### ######
##  ######
## #######
##    ####
#### #####
##    ####
##   #####
#  #######
##  ######
### ######
##  ######
## #######
##    ####
#### #####
##    ####
##   #####
#  #######
##  ######
### ######
##  ######
## #######
##    ####
#### #####
##    ####
##   #####
#  #######
##  ######
##    ####
#### #####
##    ####
##   #####
#  #######
##  ######
### ######
##  ######
## #######
##    ####
#### #####
##    ####
##   #####
#  #######
##  ######
### ######
##  ######
## #######
##    ####
#### #####
##    ####
##   #####
#  #######
##  ######
### ######
##  ######
## #######
## #######
## #######
## #######
## #######
## #######
## #######
##E#######