###E############################################################################################
#   # # ##
### ## #
#   ####
### ####
#S  ####