  ###E####
  #   # # 
  ### ## #
  #   ####
##### ####
  #S  ####