  ###E####
  #   # # 
  ### ## ####
  #   ####
##### ####
  #S  ####