#####S##
E#    ##
####  ##
##   E##
#   ####
###  ###
##E#####