#####S#####
##     ####
#####  ####
###### ####
#####  ####
###   #####
#####E#####
#        #
#