   ###E#############################################################################################
   #   # # ##############################################################
  #### ## #
## #   ####
   ### ####
   #S  ####