##############
####SS    ####
##    ##  ####
#  # #   ##S##
## ### #  ####
########E#####
