#####S#####
##     ####
#####  ####
###### ####
#####  ####
###   #####
#####E#####
#
#