###E###########################################################################################
#   # # ##
### ## #
#   ####
### #######
#S  ####