##############
####S     ####
##    ##  ####
#  # #   ## ##
## ### #  ####
##############
