   ###E####
   #   # # 
  #### ## #
## #   ####
   ### ####
   #S  ####