########E#######
##  ###   #### #
#  #  #  ##  ###
# ###   ### ####
# #### #########
######S#########
                