####S#########
####      ####
##    ##  ####
#  # #   #####
## ### #  ####
######E#######
