#E######
#   ####
#    ###
###  ###
#### ###
####S###