#################E#######
#####   ###    ##  ######
# #  ## ##  # #     #####
#    ####       ### #####
###  ####### ######  ####
### ####   #######  #####
###   #   #########  ####
#   ####               ##
#######  #S##############
#######  #  #############
#########################