#################S#######
#####   ###    ##  ######
# #  ## ##  # #   #######
#    ####       #########
### ######  #######  ####
### ####   #######  #####
###   #   #########  ####
#                    E ##
#######     #############
#######     #############
#########################