 ################
 ##  ###   #### #
 #  #  #  ##  ###
 S ###   ### ####
 # #### #########
 ######E#########