################ 
##  ###   #### S 
#  #  #  ##  ### 
# ###   ### #### 
# #### ######### 
######E######### 