                
########S#######
##  ###   #### #
#  #  #  ##  ###
# ###   ### ####
# #### #########
######E#########