########
#   # ##
### ## #
#   ####
# # ####
#S#E####