#################E#######
#####   ###    ##  ######
# #  ## ##  # #   #######
#    ####       #########
### ######  #######  ####
### ####   #######  #####
###   #   #########  ####
#                      ##
#######  S  #############
#######     #############
#########################